11111111111111111111111111111111111111111111111111
100000000000000000000010011EPC00000000000000000001
1X0X1111111111111111111111111111111111111111111101
10000000000000000000000011000000000000000000000001
11111111111111111111111011011111111111111111111111
1000000X10X0000001X00X00110000111000X000X000X000X1
10X0X10000001X1X0000000X1111100000X000X000X0001001
10111111111111111111111111111111111111111111111101
100000X000X000100000111111000X000000X000000100X001
1X0X10001000X000X00X11111101000X101000X00X00000001
100X1111111111111111111111011111111111111111111111
11000000000000000000000011000000000000000000000001
11111111111111111111111011111111111111111111111101
10X000X000X000X000X000X0110101X10X10001X1X1X100001
100010001000100010001000000000000000X000000000X001
11111111111111111111111111111111111111111111111111
