1111111111111
10010000000C1
100E011111X01
1P00111000001
1111111111111
