11111111111111111111111111111111111111111111111111
100000000C00000000000010011EP000000CCCCCCCCCCCCCC1
1X0X1111111111111111111111111111111111111111111101
10000000C00000C0000C0000110C0C0C0C0C0C0C0C0C0C0C01
11111111111111111111111011011111111111111111111111
1000000X1CX0C00C01X0CX00110C00111000X0C0X000X00CX1
10X0X1C0C0001X1X0000000X1111100C00XC00X00CXC001001
10111111111111111111111111111111111111111111111101
100000X000X00C10000C111111000X00C0C0X00000C100XC01
1X0X1000100CX000XCCX11111101C00X10100CX0CX00C000C1
100X1111111111111111111111011111111111111111111111
110000000000000C0000000C11000C00000C00000C00000C01
11111111111111111111111011111111111111111111111101
10X0C0X0C0X0C0X0C0X0C0X011C1C1X1CX10C01X1X1X100001
100010001000100010001000000000000000X000C00C00XC01
11111111111111111111111111111111111111111111111111
